As Plain As It Gets
9
0000000000000
0000000000000
1111111111111
2222222222222
3333333333333
4444444444444
5555555555555
6666666666666
6666666666666

X Marks The Spot
9
0000000000000
0000000000000
0888000008880
0022200022200
0003330333000
0000444440000
0003330333000
0022200022200
0888000008880

Bouncy Bouncy
10
0000000000000
0800800080080
0000000000000
9090909090909
0000000000000
0100200030040
0000000000000
0808080808080
0000000000000
1234123412341

Tubes
9
0000000000000
7777777777777
6666666666666
0000000000000
9909990999099
0909090909090
9909990999099
0000000000000
4567456745674
5674567456745

Too Easy?
10
8989898989898
1291234591234
1239123459123
1234912345912
1234591234591
8988889888898
0000000000000
7777777777777
5555555555555
3333333333333

