Bouncy Bouncy
10
0000000000000
0800800080080
0000000000000
9090909090909
0000000000000
0100200030040
0000000000000
0808080808080
0000000000000
1234123412341
1
