As Plain As It Gets
8
0000000000000
1111111111111
2222222222222
3333333333333
4444444444444
5555555555555
6666666666666
7777777777777
1
