Tubes
9
0000000000000
7777777777777
6666666666666
0000000000000
9909990999099
0909090909090
9909990999099
0000000000000
4567456745674
5674567456745
1
