X Marks The Spot
9
0000000000000
0000000000000
0888000008880
0022200022200
0003330333000
0000444440000
0003330333000
0022200022200
0888000008880
1
